3,3,3,3,3,3,3,3,3,3,3,3,3,3,3,3,3,3,3,3,3,3,3,3,3,3,3,3,3,3,3,3,3,3,3,3,3,3,3,3,
3,3,3,3,3,3,3,3,3,3,3,3,3,3,3,3,3,3,3,3,3,3,3,3,3,3,3,3,3,3,3,3,3,3,3,3,3,3,3,3,
3,3,0,0,0,0,0,0,0,0,0,0,0,0,0,0,0,0,0,0,0,0,0,0,0,0,0,0,0,0,0,0,0,0,0,0,0,0,3,3,
3,3,0,0,0,0,0,0,0,0,0,0,0,0,0,0,0,0,0,0,0,0,0,0,0,0,0,0,0,0,0,0,0,0,0,0,0,0,3,3,
3,3,0,0,0,0,0,0,0,0,0,0,0,0,0,0,0,0,0,0,0,0,0,0,0,0,0,0,0,0,0,0,0,0,0,0,0,0,3,3,
3,3,0,0,0,0,0,0,1,3,1,3,1,0,0,0,0,1,3,1,3,1,0,0,0,0,1,3,1,3,1,0,0,0,0,0,0,0,3,3,
3,3,0,0,0,0,0,0,3,4,4,4,3,0,0,0,0,3,4,4,4,3,0,0,0,0,3,4,4,4,3,0,0,0,0,0,0,0,3,3,
3,3,0,0,0,0,0,0,1,4,4,4,1,0,0,0,0,1,4,4,4,1,0,0,0,0,1,4,4,4,1,0,0,0,0,0,0,0,3,3,
3,3,0,0,0,0,0,0,3,1,3,1,3,0,0,0,0,3,1,3,1,3,0,0,0,0,3,1,3,1,3,0,0,0,0,0,0,0,3,3,
3,3,0,0,0,0,0,0,0,0,0,0,0,0,0,0,0,0,0,0,0,0,0,0,0,0,0,0,0,0,0,0,0,0,0,0,0,0,3,3,
3,3,0,0,0,0,0,0,0,0,0,0,0,0,0,0,0,0,0,0,0,0,0,0,0,0,0,0,0,0,0,0,0,0,0,0,0,0,3,3,
3,3,0,0,0,0,0,0,0,0,0,0,0,0,0,0,0,0,0,0,0,0,0,0,0,0,0,0,0,0,0,0,0,0,0,0,0,0,3,3,
3,3,0,0,0,0,0,0,0,0,0,0,0,0,0,0,0,0,0,0,0,0,0,0,0,0,0,0,0,0,0,0,0,0,0,0,0,0,3,3,
3,3,0,0,0,0,0,0,1,3,1,3,1,0,0,0,0,1,3,1,3,1,0,0,0,0,1,3,1,3,1,0,0,0,0,0,0,0,3,3,
3,3,0,0,0,0,0,0,3,4,4,4,3,0,0,0,0,3,4,4,4,3,0,0,0,0,3,4,4,4,3,0,0,0,0,0,0,0,3,3,
3,3,0,0,0,0,0,0,1,4,4,4,1,0,0,0,0,1,4,4,4,1,0,0,0,0,1,4,4,4,1,0,0,0,0,0,0,0,3,3,
3,3,0,0,0,0,0,0,3,1,3,1,3,0,0,0,0,3,1,3,1,3,0,0,0,0,3,1,3,1,3,0,0,0,0,0,0,0,3,3,
3,3,0,0,0,0,0,0,0,0,0,0,0,0,0,0,0,0,0,0,0,0,0,0,0,0,0,0,0,0,0,0,0,0,0,0,0,0,3,3,
3,3,0,0,0,0,0,0,0,0,0,0,0,0,0,0,0,0,0,0,0,0,0,0,0,0,0,0,0,0,0,0,0,0,0,0,0,0,3,3,
3,3,0,0,0,0,0,0,0,0,0,0,0,0,0,0,0,0,0,0,0,0,0,0,0,0,0,0,0,0,0,0,0,0,0,0,0,0,3,3,
3,3,3,3,3,3,3,3,3,3,3,3,3,3,3,3,3,3,3,3,3,3,3,3,3,3,3,3,3,3,3,3,3,3,3,3,3,3,3,3,
3,3,3,3,3,3,3,3,3,3,3,3,3,3,3,3,3,3,3,3,3,3,3,3,3,3,3,3,3,3,3,3,3,3,3,3,3,3,3,3